R 768 1068 
NO ./textures/bluestone.xpm
SO ./textures/colorstone.xpm
WE ./textures/greystone.xpm
EA ./textures/purplestone.xpm
S ./textures/pillar.xpm
F 51,51,51
C 102,204,255

        11111111
1111111111000001
1N00000001100001
1000000001100001
1000000000000001
1011200000000001111111
1000100000000000000001
1020000000000001111111
1111111110111111
        101
        101
        101
        101
        101
        101
        101
        101
        101
        101
        101
        101
        101
        101
        101
        101
        101
        101
        111