R 1000 1000
NO ./textures/bluestone.xpm
SO ./textures/colorstone.xpm
WE ./textures/greystone.xpm
EA ./textures/purplestone.xpm
S ./textures/pillar.xpm
F 220,100,0
C 225,30,0

    11111
    10001
    10001
11111000111111111111111
10000000000000000000001
100000N0000000000000111
111111100111111111111
      1001
      1111
