F 68,68,34
C 150,30,0

SO                   ./textures/colorstone.xpm


R    1920 1080
NO       ./textures/bluestone.xpm
WE   ./textures/greystone.xpm
EA                     ./textures/purplestone.xpm


S  ./textures/pillar.xpm


1111111         11111111        111111111
1000001         10000001        100000001
1002001         10200011        100000001
1000001         10021111        100111001
1111001         12222221        100110011
   1001         12222221        100100001
   100111111111112222221        100100001
11110000000000000002000111111111100100001
1000000000000000000000000000000000010000111
100000000000000000000S000000000000010000001
1111111111111111111100001111111111111111101
                   101001               101
                   100001               101
11111111111111111111000011111111111111111011111
10000000000000000000000000200000000000000000001
10000000000000000000000000000000000000000000001
11111110011111111000001000111111111100111111111
      1001      1000001000001      1001
11111110011111111110001000001111111100111111111
10000000000000000000001000000000000000000000001
10000000011111111000201000001111111100000020001
1000200001      1000001000001      100000000001
1111111111      1111111111111      111111111111